NO ./PATH
SO ./PATH
WE ./PATH
EA ./PATH

C 220,30,0
F 420,69,0

111111
100101
101001
1100 01
111111