NO ./textures/circles.xpm
SO ./textures/wood.xpm
WE ./textures/hypno.xpm
EA ./textures/bricks.xpm

C 10,10,255
F 10,255,10

111111111      11111111
110000011      10000001
11000001111    10000001
11000000001111110000001
11000S00000000000000001
11000000001111110000001
11000001111    10000001
11111111       11111111