NO ./textures/circles.xpm
SO ./textures/wood.xpm
WE ./textures/hypno.xpm
EA ./textures/bricks.xpm

C 220,30,0
F 120,69,0

11111111
10000011
100000111
10000000011111
1000S0000000001
10000000011111
100000111
1111111