111111
100101
101001
1100 01
111111