NO ./textures/circles.xpm
SO ./textures/wood.xpm
WE ./textures/hypno.xpm
EA ./textures/bricks.xpm

C 10,10,255
F 10,255,10

1111111111111111111111
1000001111111110000001
1000001111111110000001
1000000001111110000001
1000S00000000000000001
1000000001111110000001
1000001111111110000001
1111111111111111111111