NO ./textures/circles.xpm
SO ./textures/wood.xpm
WE ./textures/hypno.xpm
EA ./textures/bricks.xpm

C 10,10,255
F 10,255,10

111111111111111111111111111
100000111111111000000111111
100000111111111000000011111
100000000111111000000111111
1000S0000000000000000111111
100000000111111000000011111
100000111111111000000111111
111111111111111111111111111