NO ./textures/bricks.xpm
SO ./textures/circles.xpm
WE ./textures/hypno.xpm
EA ./textures/wood.xpm

C 220,30,0
F 120,69,0


1111111
1001011
1001111
1100011
1000S01
1110001
1000001
1111111