NO ./PATH
SO ./PATH
WE ./PATH
EA ./PATH

C 220,30,0
F 120,69,0


1111111
1001011
1001111
1100011
100N0301
1110001
1000001
1111111