NO ./textures/bricks.xpm
SO ./textures/circles.xpm
WE ./textures/hypno.xpm
EA ./textures/wood.xpm

C 0,0,255
F 0,255,0

 11111         111111
1000001       100000011
1000001111    100000001
10000000011111000000111111
1000S00000000000000001
10000000011111100000001
1000001111    10000001
 11111         111111