NO ./textures/bricks.xpm
SO ./textures/wood.xpm
WE ./textures/circles.xpm
EA ./textures/hypno.xpm

C 220,30,0
F 120,69,0

111111111
111111111
110000011
110000011111111
110000000011111
11000S000000011
110000000011111
110000011111111
111111111
111111111