NO ./textures/circles.xpm
SO ./textures/wood.xpm
WE ./textures/hypno.xpm
EA ./textures/bricks.xpm

C 10,10,255
F 10,255,10

 11111         111111
1000001       10000001
1000001111    10000001
10000000011111100000001
1000S00000000000000001
10000000011111100000001
1000001111    10000001
 11111         111111