NO ./textures/circles.xpm
SO ./textures/wood.xpm
WE ./textures/hypno.xpm
EA ./textures/bricks.xpm

C 220,30,0
F 120,69,0

1111111111
1111111111
1100000111
110000011111
11000000001111111
11000S00000000011
11000000001111111
110000011111
1111111111
1111111111