NO ./textures/circles.xpm
SO ./textures/wood.xpm
WE ./textures/hypno.xpm
EA ./textures/bricks.xpm

C 10,10,255
F 10,255,10

111111111111111111111111111111111
10000000000000000000001
10000000000000000000001
10011100111111111111111
1001S1001
10011100111111111111111111
10000000000000000000000001
11111111111111111111111111